  { 0,  8,  8,  8,  8,  8,  8,  8,  8,  8,  8,  8,  8, 24, 16,  8,  8,  8,  8,  8,  8,  8,  8,  8,  8,  8,  8,  4},
    {13, 26, 26, 26, 26, 26, 26, 26, 26, 26, 26, 26, 26, 14, 15, 26, 26, 26, 26, 26, 26, 26, 26, 26, 26, 26, 26, 12},
    {13, 26,  2, 11, 11,  6, 26,  2, 11, 11, 11,  6, 26, 14, 15, 26,  2, 11, 11, 11,  6, 26, 3 2, 11, 11,  6, 26, 12},
    {13, 27, 14, 30, 30, 15, 26, 14, 30, 30, 30, 15, 26, 14, 15, 26, 14, 30, 30, 30, 15, 26, 14, 30, 30, 15, 27, 12},
    {13, 26,  3, 10, 10,  7, 26,  3, 10, 10, 10,  7, 26,  3,  7, 26,  3, 10, 10, 10,  7, 26,  3, 10, 10,  7, 26, 12},
    {13, 26, 26, 26, 26, 26, 26, 26, 26, 26, 26, 26, 26, 26, 26, 26, 26, 26, 26, 26, 26, 26, 26, 26, 26, 26, 26, 12},
    {13, 26,  2, 11, 11,  6, 26,  2,  6, 26,  2, 11, 11, 11, 11, 11, 11,  6, 26,  2,  6, 26,  2, 11, 11,  6, 26, 12},
    {13, 26,  3, 10, 10,  7, 26, 14, 15, 26,  3, 10, 10,  6,  2, 10, 10,  7, 26, 14, 15, 26,  3, 10, 10,  7, 26, 12},
    {13, 26, 26, 26, 26, 26, 26, 14, 15, 26, 26, 26, 26, 14, 15, 26, 26, 26, 26, 14, 15, 26, 26, 26, 26, 26, 26, 12},
    { 1,  9,  9,  9,  9,  6, 26, 14,  3, 11, 11,  6, 30, 14, 15, 30,  2, 11, 11,  7, 15, 26,  2,  9,  9,  9,  9,  5},
    {30, 30, 30, 30, 30, 13, 26, 14,  2, 10, 10,  7, 30,  3,  7, 30,  3, 10, 10,  6, 15, 26, 12, 30, 30, 30, 30, 30},
    {30, 30, 30, 30, 30, 13, 26, 14, 15, 30, 30, 30, 30, 30, 30, 30, 30, 30, 30, 14, 15, 26, 12, 30, 30, 30, 30, 30},
    {30, 30, 30, 30, 30, 13, 26, 14, 15, 30, 18,  9,  9, 31, 31,  9,  9, 22, 30, 14, 15, 26, 12, 30, 30, 30, 30, 30},
    { 8,  8,  8,  8,  8,  7, 26,  3,  7, 30, 12, 30, 30, 30, 30, 30, 30, 13, 30,  3,  7, 26,  3,  8,  8,  8,  8,  8},
    {30, 30, 30, 30, 30, 30, 26, 30, 30, 30, 12, 30, 30, 30, 30, 30, 30, 13, 30, 30, 30, 26, 30, 30, 30, 30, 30, 30},
    { 9,  9,  9,  9,  9,  6, 26,  2,  6, 30, 12, 30, 30, 30, 30, 30, 30, 13, 30,  2,  6, 26,  2,  9,  9,  9,  9,  9},
    {30, 30, 30, 30, 30, 13, 26, 14, 15, 30, 19,  8,  8,  8,  8,  8,  8, 23, 30, 14, 15, 26, 12, 30, 30, 30, 30, 30},
    {30, 30, 30, 30, 30, 13, 26, 14, 15, 30, 30, 30, 30, 30, 30, 30, 30, 30, 30, 14, 15, 26, 12, 30, 30, 30, 30, 30},
    {30, 30, 30, 30, 30, 13, 26, 14, 15, 30,  2, 11, 11, 11, 11, 11, 11,  6, 30, 14, 15, 26, 12, 30, 30, 30, 30, 30},
    { 0,  8,  8,  8,  8,  7, 26,  3,  7, 30,  3, 10, 10,  6,  2, 10, 10,  7, 30,  3,  7, 26,  3,  8,  8,  8,  8,  4},
    {13, 26, 26, 26, 26, 26, 26, 26, 26, 26, 26, 26, 26, 14, 15, 26, 26, 26, 26, 26, 26, 26, 26, 26, 26, 26, 26, 12},
    {13, 26,  2, 11, 11,  6, 26,  2, 11, 11, 11,  6, 26, 14, 15, 26,  2, 11, 11, 11,  6, 26,  2, 11, 11,  6, 26, 12},
    {13, 26,  3, 10,  6, 15, 26,  3, 10, 10, 10,  7, 26,  3,  7, 26,  3, 10, 10, 10,  7, 26, 14,  2, 10,  7, 26, 12},
    {13, 27, 26, 26, 14, 15, 26, 26, 26, 26, 26, 26, 26, 30, 30, 26, 26, 26, 26, 26, 26, 26, 14, 15, 26, 26, 27, 12},
    {17, 11,  6, 26, 14, 15, 26,  2,  6, 26,  2, 11, 11, 11, 11, 11, 11,  6, 26,  2,  6, 26, 14, 15, 26,  2, 11, 25},
    {28, 10,  7, 26,  3,  7, 26, 14, 15, 26,  3, 10, 10,  6,  2, 10, 10,  7, 26, 14, 15, 26,  3,  7, 26,  3, 10, 20},
    {13, 26, 26, 26, 26, 26, 26, 14, 15, 26, 26, 26, 26, 14, 15, 26, 26, 26, 26, 14, 15, 26, 26, 26, 26, 26, 26, 12},
    {13, 26,  2, 11, 11, 11, 11,  7,  3, 11, 11,  6, 26, 14, 15, 26,  2, 11, 11,  7,  3, 11, 11, 11, 11,  6, 26, 12},
    {13, 26,  3, 10, 10, 10, 10, 10, 10, 10, 10,  7, 26,  3,  7, 26,  3, 10, 10, 10, 10, 10, 10, 10, 10,  7, 26, 12},
    {13, 26, 26, 26, 26, 26, 26, 26, 26, 26, 26, 26, 26, 26, 26, 26, 26, 26, 26, 26, 26, 26, 26, 26, 26, 26, 26, 12},
    { 1,  9,  9,  9,  9,  9,  9,  9,  9,  9,  9,  9,  9,  9,  9,  9,  9,  9,  9,  9,  9,  9,  9,  9,  9,  9,  9,  5}